%%%%%%%%%%%%%%%%%%%%%%%%%%%%%%%%%
%                 %         %  P%
% %%%%% %%%%%%%%% % % %%%%% % %%%
% %   %     % %   % %   %   %   %
% % %%%%%%% % % %%%%% % %%% %%% %
%   %   %   % %     % %   %     %
%%%%% % % %%% %%%%% %%%%% %%%%% %
% %   %   %       % %     %   % %
% % %%%%%%% %%%%% % % %%%%%%% % %
%   %     %     % % % %       % %
%%%%%%% % % %%% %%% % %%% %%% % %
%       % %   %   %   %   %   % %
%%% %%%%%%%%% %%% %%%%% %%%%%%% %
%   %       %   %       %       %
% %%% %%%%% %%% %%%%% %%% %%%%%%%
%.        %         %           %
%%%%%%%%%%%%%%%%%%%%%%%%%%%%%%%%%