%%%%%%%%%%%%%%%%%
%     %   % %  P%
% % %%% % % % % %
% %     % %   % %
% %%%%%%% %%%%% %
%     % % %     %
%%%%% % %%% %%% %
%.          %   %
%%%%%%%%%%%%%%%%%